11111111111
100E0100001
100000P0001
10001000001
100C0010001
10000000001
11111111111