11111111111
1111CC01111
1111PC01111
1111C001111
11110001111
11C00E00011
11111111111