11111111111
111100000C1
10000111111
11110000011
11110CC1111
1101E1000P1
11111111111