11111111111
10E00000001
10000000001
10000000P01
10000000001
10000000P01
11111111111