11111111
100EC001
10000P01
11111111
