1111111111111111111
100000P1100C0001001
101111011000110C101
1000001110001100001
1110000000001100001
1111111111111111111
