1111111111111
1001000a000C1
100 111112001
1P0011E000001
1111111111111
