0000000000000000000
000000P1100C0001000
0E1111011000110C100
0000001110001100000
0110000000001100000
0000000000000000000
