111111111111111111111111111111111111111
1P0000010100CN00001001C0000110000100001
11111101100001100010101001101010110C101
1C00001110000011000CCCC111000011111N001
1110000C00001100000111101010C0CC0101101
10000011000C11001001000110C00C0C1100001
111C111C0011111C10010C011100C11CCC00001
10000011100000110N0011000CCC00011010101
1C100000000011000000111N00000000000C001
10000011000CN100100C00000000CCC000N1111
111C111C001111NC100111111CC000001111111
1000001110000001000011N1111111101110C11
1110000000001100000N100000CCC0000000111
10000011000C1100100110111111111111NCN11
111C111C0011111CN001100C000110000111111
1C00001110000011000011NN1101101100000C1
1110000001CN110000001000000100010111101
1C000011000C00001001101111110101C000001
111CN11C0011110CN00110000C0000011N0N101
1NNNNNNNNNNNNNNNNNNNNNNNNNNNNNNNNN0N101
1EC000C00000000000000000C000C0C0000N101
1NNNNNNNNNNNNNNNNNNNNNNNNNNNNNNNNNNN1C1
111111111111111111111111111111111111111
11111111111111111DDDDD11111111111111111
111111111111111111111111111111111111111
