111111111111111111111
1000000000000000000E1
10000000C000000000001
100000000000000C00001
100C00000000000000001
100000000C00000000001
100000000P000000000C1
111111111111111111111
