111111111111111111111
100000P1100C000001001
1E111101100000110C101
100000011000001100001
111000000000110000001
10000011000C110010011
111C111C0011111010011
111111111111111111111
