11111111111111111111
1010110000000C100001
1010C001001101101CC1
1000011N11000C101C01
10C0010001000000C101
1001N1111111111011C1
1000C1P0001C00100001
100C01111011101C1011
10110C0C1001C01C1011
1C0000C00001001C10C1
1111N11110111C111101
1C0C0C0C0000001E0001
11111111111111111111
