111111111111111111111
100000P1100C000001001
10111101100000110C101
100000111000001100001
111000000000110000001
10000011000C110010011
111C111C0011111C10011
1000000C0001100100001
100CCCCC11111000000C1
100000C1100C000001001
10111101100000110C101
100000111000001100001
111000000000110000001
10000011000C110010011
111C111C0011111C10011
1000000C0001100100001
100CCCCC11111000000C1
10000011100C000001001
10111101100000110C101
100000111000001100001
111000000000110000001
10000011000C110010011
111C111C0011111C10011
1000000C0001100100001
100CCCCC1111100000EC1
111111111111111111111
