1111111111111111111
10000001100C0001001
1E11110110001101101
1000001110001100001
1110000000001100001
1111111111111111111
