11111111111111111111111
11111111111111111111111
1100000P1100C0000010011
11E111101100000110C1011
11000001110000011000011
11110000000001100000011
110000011000C1100100111
1111C111C0011111c100111
11111111111111111111111
11111111111111111111111
