1111111111111111111
100000P110000001001
1E11110110001100101
1000001110001100001
1110000000001100001
1111111111111111111
