11111111111111
11111111111111111
1111111111111111111
1100000P1100C0001001
11E1111011000110C101
1100001110001100001
10000000001100001
11111111000011111
1111111111111111
1111111111111
